11111111111111111111111111111111111111111111111111
1E0000000000001C00000C0000000000010000000000001C01
11000101001000111010010000000101000000000000001C01
10100100101010100010010000000101000000000000001C01
1P0000000C00C0000000000000000000C00000000000001C01
11000101001000111010010000000101000000000000001C01
10100100101010100010010000000101000000000000001C01
11000101001000111010010000000101000000000000001C01
10100100101010100010010000000101000000000000001C01
11000101001000111010010000000101000000000000001C01
10100100101010100010010000000101000000000000001C01
11000101001000111010010000000101000000000000001C01
10100100101010100010010000000101000000000000001C01
11000101001000111010010000000101000000000000001C01
10100100101010100010010000000101000000000000001C01
11000101001000111010010000000101000000000000001C01
10100100101010100010010000000101000000000000001C01
11000101001000111010010000000101000000000000000C01
10100100101010100010010000000101000000000000001C01
10100100101010100010010000000101000000000000001C01
11000101001000111010010000000101000000000000001C01
10100100101010100010010000000101000000000000001C01
11000101001000111010010000000101000000000000001C01
10100100101010100010010000000101000000000000001C01
11000101001000111010010000000101000000000000001C01
10100100101010100010010000000101000000000000001C01
11000101001000111010010000000101000000000000001C01
10100100101010100010010000000101000000000000001C01
11000101001000111010010000000101000000000000001C01
10100100101010100010010000000101000000000000001C01
10100100101010100010010000000101000000000000001C01
11000101001000111010010000000101000000000000001C01
10100100101010100010010000000101000000000000001C01
11000101001000111010010000000101000000000000001C01
10100100101010100010010000000101000000000000001C01
11000101001000111010010000000101000000000000001C01
10100100101010100010010000000101000000000000001C01
11000101001000111010010000000101000000000000001C01
10100100101010100010010000000101000000000000001C01
11111111111111111111111111111111111111111111111111