1111111111111111111111111111111111
1E00000XXXXX001C00000CXXXXXX000001
110001010010001110100100X000010101
101001001010101000100100XX00010101
1P000XX00C00C00000000000X0000000C1
11XX010100100011101001000000010101
1010010010101010001001000000010101
11XX010100100011101001000000010101
1010010010101010001001000000010101
1100010100100011101001000000010101
1010010010101010001001000000010101
1100010100100011101001000000010101
1010010010101010001001000000010101
1100010100100011101001000000010101
1010010010101010001001000000010101
1100010100100011101001000000010101
1010010010101010001001000000010101
1100010100100011101001000000010101
1010010010101010001001000000010101
1010010010101010001001000000010101
1100010100100011101001000000010101
1010010010101010001001000000010101
1100010100100011101001000000010101
1010010010101010001001000000010101
1100010100100011101001000000010101
1010010010101010001001000000010101
1100010100100011101001000000010101
1010010010101010001001000000010101
1100010100100011101001000000010101
1010010010101010001001000000010101
1010010010101010001001000000010101
1100010100100011101001000000010101
1010010010101010001001000000010101
1100010100100011101001000000010101
1010010010101010001001000000010101
1100010100100011101001000000010101
1010010010101010001001000000010101
1100010100100011101001000000010101
1010010010101010001001000000010101
1111111111111111111111111111111111