1111111111111111111111111111111111
1E0X000000X0001C00000C000X00000001
1100010100100011101001000000010101
101001001010101000100100X000010101
1P0000000C00C0000X0000000000000001
1111111111111111111111111111111111